19
17
1 1 1 1 1 1 1 8 8 8 1 1 1 1 1 1 1
7 8 2 2 2 2 2 2 2 2 2 2 2 2 2 2 4
7 8 2 2 2 2 2 2 2 2 2 2 2 2 2 8 4
7 2 8 2 2 2 2 2 2 2 2 2 8 2 2 8 4
7 2 2 2 2 2 2 2 2 2 2 2 2 2 2 2 4
7 2 2 2 2 2 2 2 2 2 8 2 2 8 2 2 4
8 2 2 2 2 2 2 2 2 2 2 2 2 2 2 2 8
8 2 2 8 2 2 2 2 2 2 2 2 2 2 2 2 8
8 2 2 8 2 2 2 2 2 2 2 2 2 2 2 2 8
7 2 2 2 2 2 2 2 2 2 2 2 2 2 2 2 4
7 2 2 2 8 2 2 8 2 2 2 2 2 2 2 2 4
7 2 2 2 2 2 2 2 2 2 8 2 2 2 2 2 4
7 2 2 2 2 2 2 2 2 8 8 2 2 2 2 2 4
7 2 2 2 2 2 2 2 2 2 2 2 2 2 2 2 4
6 6 6 6 6 6 6 8 8 8 6 6 6 6 6 6 6
0 0 0 0 0 0 0 0 0 0 0 0 0 0 0 0 0
0 0 0 0 0 0 0 3 5 5 5 0 0 0 0 0 0
0 0 0 0 0 0 0 5 5 5 5 0 0 0 0 0 0
0 0 0 0 0 0 0 0 0 0 0 0 0 0 0 0 0